#########...#####
###..K......#####
###.............#
............##O##
@.S..sokoban.B...
............###N.
###.O...........#
###...........###
#########...#####